grappig	aj	funny, facetious, comical, amusing
aardappel	n	potato
pantoffel	n	slipper (footwear)
kachel	n	stove, oven, kiln, heater, furnace; drunk
glimlach	n	smile
opgelucht	aj	relieved
vuilnis	n	garbage, trash
spiegelbeeld	n	mirror image
belachelijk	aj	ridiculous
reusachtig	aj	gigantic
winkelwagentje	n	shopping cart
ginnegappen	v	to snigger, sneer, giggle
pardoes	ad	smack; bang
luier	n	diaper
ontbijt	n	breakfast
bolleboos	n	swell, sap, dab
smeerlap	n	swine, greasy rag, bum, blighter
binnenstad	n	city center, old town
zorgeloos	aj	carefree
moe	aj	tired, weary
leuk	aj	nice, funny, entertaining, amusing
aardig	aj	relatively, pretty, pleasant, nice, kind, good-natured, funny, friendly, fairly, entertaining, dainty, amusing, affable
klootzak	n	bastard (lit. scrotum)
saai	aj	tiresome, slow, serge, monotonous, lifeless, dull
makkelijk	aj	easy
dier	n	animal
misselijk	aj	sickening, sick, nauseous, disgusting, abhorrant
verkeer	n	traffic; intercourse
lente	n	spring, springtime
flink	aj	vigorous, tidy, thorough, substantial, strapping, stiff, stalwart, spirited, sound, solid, smart, sizable, robust, pushing, plucky, nice, managing
beker	n	cup, mug
begrafenis	n	funeral
verstandskies	n	wisdom tooth
lullig	aj	silly, sad, pathetic, lame
bot	n, aj	bone; blunt
hersenen	n	brains, brain matter
snor	n	moustache
groente	n	vegetable(s)
taai	aj	tough, viscous, tedious
hagelslag	n	chocolate sprinkles
jurk	n	dress, gown
stamgast	n	regular customer
vlinder	n	butterfly
wolk	n	cloud, whiff
zielepoot	n	loser, wretch, underdog
huilebalk	n	crybaby
ei	n	egg
overloop	n	passage, landing, corridor
lafaard	n	coward
sukkel	n	dope, idiot, twerp
sinaasappelsap	n	orange juice
bijzonder	n	special, remarkable
geweld	n	violence
regenboog	n	rainbow
gereedschap	n	tools, equipment
voorkruipen	v	to sneak to the front of a line
zacht	aj	soft, smooth, slow, mild, gentle
knutselen	v	to tinker, potter
zenuwachtig	aj	nervous, itchy
kleren	n	clothes
washandje	n	washing cloth
spoorwegovergang	n	railroad crossing
blij	aj	pleased, happy, glad
kapstok	n	coat rack
herfst	n	autumn, fall
parmantig	n	jaunty, dapper
grijns	n	smirk
mager	n	skinny, thin
knus	aj	snug, intimate, comfy
sleutelgat	n	keyhole
eend	n	duck
aandacht	n	attention
verliefd	aj	in love, enamored, amorous
jas	n	jacket, coat
verzinsel	n	invention, concoction
huisarts	n	family doctor
badmeester	n	bath superintendent
leraar	n	teacher, professor
misdaad	n	crime
bezopen	aj	drunk, plastered; outrageous
meisje	n	girl
kroeg	n	bar, pub
plezier	n	fun, pleasure
lanterfanten	v	to lounge, loaf about
lichaam	n	body
speelgoed	n	toy, toys
grot	n	cave
oorlog	n	war, warfare
hufter	n	lout, hopper, clod, oaf
vrede	n	peace
huppelen	v	to skip, frisk
fiets	n	bicycle
klomp	n	wooden shoe; clump
taart	n	pie, cake
zaagsel	n	sawdust
knipoog	n	wink
kip	n	chicken
been	n	leg, paw, bone, side
ui	n	onion
blut	aj	broke, cleaned out
paars	n, adj	purple
moeilijk	aj	difficult, hard
frisdrank	n	soft drink, soda
bloot	aj	nude, naked
ongeveer	ad	roughly, around, approximately, approximate, about
smerig	n	disgusting, gross
peuk	n	cigarette butt
potlood	n	pencil
ruiken	v	to smell
rug	n	back
schoolbord	n	black board
twijfel	n	doubt
vlug	aj	soon, smart, quick, nimble, fast
ruzie	n	row, quarrel
akker	n	field
zwerver	n	wanderer, vagabond, tramp
verf	n	paint
gezicht	n	face
paardenstaart	n	ponytail
kwajongen	n	urchin, naughty boy, lout
verhaal	n	tale, story, narrative, history, account
rekening	n	check, bill, account
toekomst	n	future
bruiloft	n	wedding
klap	n	slap, crack, blow
gisteren	n	yesterday
vrijen	v	to make love
vlees	n	meat
bord	n	plate; sign; board
ongelooflijk	aj	incredible
besmuikt	aj	sniggering; furtive
verongelijkt	aj	miffed, offended, insulted, piqued
stiekem	aj	underhand, on the sly, cagy
stilletjes	ad	quietly, silently
doodslag	n	homicide
appelmoes	n	apple sauce
dikkerd	n	fat person, fatty
kaal	aj	bald; empty, barren
leeg	aj	empty, vacant
flauwekul	n	nonsense
lepel	n	spoon
toestand	n	situation, position; mess
klodderen	n	mess around, dabble
kapsones	n	cockiness, attitude, arrogance
volwassen	aj	adult, grown up
kleuter	n	toddler
aangenaam	aj	nice, pleasurable, agreeable; nice to meet you
zeuren	v	to twaddle, dawdle
spijkerbroek	n	jeans
ezel	n	donkey, ass; easel, tressle
bewustzijn	n	consciousness
ouwehoeren	v	to chatter, chitchat, jabber, palaver, prattle (lit. old whores)
pindakaas	n	peanut butter
vandaag	n	today, present
scheermes	n	razorblade
snavel	n	beak
spulletjes	n	things, stuff
schattig	aj	adorable, affable, cute
verneuken	v	to fuck up, screw up
pet	n	cap, hat
motregen	n	light rain, drizzle
trap	n	stairs, staircase; kick, blow
dreumes	n	toddler, nipper
knikkebollen	v	to nod
spoorloos	n	trackless, traceless
verontwaardigd	aj	indignant, angry, sore
optocht	n	parade, procession	
gezellig	aj	social, sociable, pleasant, intimate, homy, cozy, companionable
rakelings	av	closely, narrowly
gevaarlijk	aj	dangerous, unsafe
veilig	aj	safe, secure
vrachtwagen	n	truck, lorry
geweten	n	conscience
alstublieft	ad	thank you; please; here you are
zwart	n	black
varken	n	pig
viezerik	n	pervert, dirty fellow
boom	n	tree
vochtig	aj	moist, humid
kraakpand	n	squatted building
nieuwsgierig	aj	nosey, inquisitive, curious
geboorte	n	birth
dutje	n	snooze, nap
niks	n	nothing
huilen	v	to cry, weep
dameskapper	n	ladies hair dresser
geschiedenis	n	history
feit	n	fact
aanslag	n	attack, assault
konijn	n	rabbit, bunny
aaien	v	to stroke, pet, caress
allemaal	ad	together, everyone
helemaal	ad	totally, completely; at all
beroemdheid	n	celebrity
badgast	n	visitor, guest, tourist
doos	n	box, case
uiteindelijk	ad	eventually, ultimately 
ergens	ad	somewhere
fles	n	bottle
gevangenis	n	prison
keihard	aj, ad	violently, intense
slager	n	butcher
ernstig	aj	severe, serious, important, grave, earnest
duwen	v	to push, shove
waarschijnlijkheid	aj	probability
baan	n	job, occupation; track, course, trajectory
graag	ad	willingly, readily, hungry, gladly, eager
aansteker	n	cigarette lighter
grappenmaker	n	wag, joker, funny man
nat	aj	wet, liquid
zomeravond	n	summer evening
tovenaar	n	wizard
boekenkast	n	book shelves, book cabinet
gebeurtenis	n	event
blaffen	v	to bark
lucifer	n	match
brandhout	n	firewood
keuken	n	kitchen
stadsgracht	n	moat
och	ad	oh! ah!
hebzucht	n	greed
kruiwagen	n	wheelbarrow
sjacheraar	n	one who barters
armoede	n	poverty
wijsneus	n	wiseass, smart aleck
voetbalwedstrijd	n	soccer match
kippenvel	n	the creeps, goose bumps
springplank	n	diving board
gordijn	n	curtain
klingelen	v	to tinkle, jingle
koffer	n	trunk, suitcase, briefcase
smeris	n	cop
asbak	n	ashtray
bos	n	woods, forest; bunch, bouquet
strandwandeling	n	stroll on the beach
kuil	n	waist, pole, pit, hole, ditch
langzaam	aj	slow, slowly, leasurely
lelijk	aj	ugly, naste, unpleasant
lucht	n	air; sky
medelijden	n	pity, compassion
franje	n	fringe, frill
dakpan	n	roof tile
boos	aj	angry
lief	aj	lovely, lovable, sweet, nice, dear
schijnheilig	aj	hypocrite, insincere
boterham	n	bread and butter; sandwich
verkeerd	aj	wrong, mistaken, incorrect, false, erroneous, bad
lekker	aj	tempting, tasty, nice, good and tasty, enticing, delicious, alluring
mooi	aj	pretty, nice, handsome, fine, beautiful
praatprogramma	n	talk show
roltrap	n	escalator
lawaai	n	noise, tumult, racket, noise, hullabaloo, din, ado
eeuw	n	age, century
buitenkansje	n	stroke of luck, opportunity
verdrietig	aj	sad, unhappy
snoeshaan	n	queer fish, foreign chap
zielig	aj	sad, pitiful, forlorn
snel	aj	swift, rapid, quick, fast
zonde	n	sin; waste
mens	n	human being
neurien	v	to hum
kijken	v	to watch
gefeliciteerd	ad	congratulations
riool	n	sewer, sewerage
tevreden	aj	content, satisfied, pleased, happy
tijdschrift	n	periodical, magazine
vrolijk	aj	merry, gay, cheerful
kikker	n	frog
roerloos	aj	motionless
vleugel	n	wing; grand piano
kofferbak	n	trunk (car)
tandarts	n	dentist
vloeitje	n	cigarette paper
stoelgang	n	stool
vloerbedekking	n	carpet, floor covering
regenjas	n	raincoat
sikje	n	goatee
strand	n	beach
leugenaar	n	liar
waarzegger	n	clearvoyant, psychic
paskamer	n	fitting room
waterkoud	aj	wet cold, brisk
ellende	n	misery, sorrow
heks	n	witch
vuurtoren	n	light house
raamkozijn	n	window frame, window sill
buitenbeentje	n	oddball, excentric crank
tierlantijn	n	frill, luxury, extravagance
luiheid	n	laziness, idleness, indolance
klokkenspel	n	chimes
spijbelen	v	to skip school, play hooky, be truant
kont	n	butt, ass, bottom, behind
uitnodiging	n	invitation
